filename, language, Python, Markdown, JSON, comment, blank, total
README.md, Markdown, 0, 10, 0, 0, 3, 13
cache\221497A7.json, JSON, 0, 0, 3137, 0, 0, 3137
cache\3D7EE688.json, JSON, 0, 0, 2973, 0, 0, 2973
cache\55C34AF1.json, JSON, 0, 0, 2591, 0, 0, 2591
cache\5D88163E.json, JSON, 0, 0, 1433, 0, 0, 1433
cache\C77B4C07.json, JSON, 0, 0, 3126, 0, 0, 3126
cache\D1986CCC.json, JSON, 0, 0, 1444, 0, 0, 1444
cache\F7BFA627.json, JSON, 0, 0, 1455, 0, 0, 1455
cma_testing\PosTrajPlot.py, Python, 13, 0, 0, 2, 4, 19
cma_testing\cma_main.py, Python, 34, 0, 0, 13, 12, 59
cma_testing\error_calculator.py, Python, 56, 0, 0, 6, 9, 71
cma_testing\matplot_slider.py, Python, 37, 0, 0, 0, 12, 49
cma_testing\multiagent_path_plot.py, Python, 25, 0, 0, 1, 7, 33
drone_simulator\camera_controller.py, Python, 61, 0, 0, 4, 9, 74
drone_simulator\drone.py, Python, 183, 0, 0, 20, 64, 267
drone_simulator\drone_initilizer.py, Python, 79, 0, 0, 19, 32, 130
drone_simulator\drone_manager.py, Python, 142, 0, 0, 5, 42, 189
drone_simulator\drone_simulator.py, Python, 78, 0, 0, 11, 21, 110
drone_simulator\formations\formation_loader.py, Python, 15, 0, 0, 18, 9, 42
drone_simulator\recorder.py, Python, 28, 0, 0, 7, 7, 42
drone_simulator\trajectories\show_traj.py, Python, 27, 0, 0, 2, 6, 35
lighthouse_testing\autonomousSequence.py, Python, 98, 0, 0, 60, 36, 194
lighthouse_testing\autonomousSequenceHl.py, Python, 137, 0, 0, 45, 31, 213
lighthouse_testing\base_station_stuff\get_bs_position.py, Python, 58, 0, 0, 9, 20, 87
lighthouse_testing\base_station_stuff\read-geometry-mem.py, Python, 26, 0, 0, 30, 14, 70
lighthouse_testing\base_station_stuff\regex_testing.py, Python, 10, 0, 0, 0, 4, 14
lighthouse_testing\base_station_stuff\upload_bs_position.py, Python, 49, 0, 0, 31, 20, 100
lighthouse_testing\circle.py, Python, 98, 0, 0, 50, 35, 183
lighthouse_testing\figure8.py, Python, 106, 0, 0, 38, 37, 181
lighthouse_testing\lighthouse_openvr_grab.py, Python, 121, 0, 0, 10, 47, 178
lighthouse_testing\print_position.py, Python, 60, 0, 0, 4, 21, 85
lighthouse_testing\transformation.py, Python, 8, 0, 0, 1, 5, 14
lighthouse_testing\transformation_matrix.py, Python, 26, 0, 0, 12, 17, 55
multiprocessing_testing.py, Python, 28, 0, 0, 1, 17, 46
testing2.py, Python, 6, 0, 0, 0, 3, 9
Total, -, 1609, 10, 16159, 399, 544, 18721